11111111111111111
10000000000011111
10111011110000001
10000000000010111
10110000110000111
11111111111111111