NO ./op.xpm
SO ./op.xpm
WE ./op.xpm
EA ./op.xpm

F 10,38,71
C 195,248,255

11111111111111111111111111111111111111111
10000010001000001000000010000000001010001
11101010101011101011101110111011101011101
10001000101010101000100000101010000000001
10101110111110101111111010101110111111111
10101010100000000010000010100010100010001
10111011111111111010111110101111111010101
10101010001000001010000010000010100000101
10101010101110111011101011111110111111101
10000010101000001000001010100010001000001
10101010111111101110111110101111101011101
10101000000010000010000000000010000000101
11101010111110111010101011101110111111111
10101010000000100000101000100000100000001
10101110111010111010101111111110101111101
1000100000101000101010100000001000001011
10111011101110101011111011101110111010101
10100010001010101000001000100010001010101
10111010101011101111101011101111101010101
10100010101000101000100000100010101010001
10111010101110101110101011111110111011101
10101010100000101000001000100010001010101
10101110101111111110101111101110101010101
10001000100010000000100010000010101010101
10101011101010101111111110111110111010111
10101010001010100000000000100000100010001
101010111110111111111111101011111111111011
10101000101000001000001000101000001000001
11101110101111111010111110101010111011111
10001000000010000010100010000010100000001
10111111111011101010101111111110111111101
10100000001000001010000010000010001010001
11101010111110111011111010111111101010101
10001010100000100000001010100000100010101
10101110101011101111101110101110111010111
1010100010101000001000001000100000001E001
10101011101010111011111111111010111010101
10101000001010101000000000001010001000101
1010111111101010101110111110101110111110111111111
1010000010001000101000000010101000000010000000001
1111111111111111111111111111111111111111100000001
                                        100000001
                                        100000001
                                        100000001
                                        100000001
                                        111111111
