1111111111111111111111111001
1000000000000000110001111001
1000000000000000110001111001
1000000000000000111110001001
1000000000000000000000001001
1000000000000000000000001001
1000000000000000000000001001
1000000000000000000000001001
1000000000000000000000001001
1000000000000000000000001001
1000000000000000000000001001
1000000000000000000000001001
1000000000000000000000001001
1000000000000000000000001001
1000000000000000000000001001
1000000000000000N00000001001
1000000000000000000000001001
1000000000000000000000001001
1111111111111111111111111001