NO ./op.xpm
SO ./op.xpm
WE ./op.xpm
EA ./op.xpm

F 220,100,0
C 225,30,0

111111111111111111
100000000000000101
100110010001111101
100000111000000001
100000000001111101
111111111111111111
