NO ./op.xpm
SO ./op.xpm
WE ./op.xpm
EA ./op.xpm

F 10,38,71
C 195,248,255


11111111111111111111111111111111111111111
10000000000000000000000000000000000000001
10000000000000000000000000000000000000001
10000000000000000000000000000000000000001
10000000000000000000000000000000000000001
10000000000000000000000000000000000000001
10000000000000000100000000000000000000001
10000000000000001000000000000000000000001
10000000000000000000000000000000100000001
10000000000000000000000000000000000000001
10000000000000000000000000000000000000001
10000000000000000000000000000000000000001
10000000000000000000000000000000000000001
10000000000000000000000000000000000000001
10000000000000000111111000000000000000001
10000000000000000000000000000000000000001
100000000000000000000000000000000000S0001
10000000000000000000000000000000000000001
1111111111111111111111111111111111111111
